1111111111
1011111111
1011100001
e011101111
1000001111
1011101111
101110000x
1011111111
1111111111
1111111111